cpx9gwv	negative
cpx9h7n	negative
cpx9lll	negative
cpx9oyg	positive
cpx9qig	positive
cpx9row	negative
cpx9s3u	positive
cpx9seg	negative
cpx9six	positive
cpx9udo	negative
cpx9vit	negative
cpxa30f	positive
cpxa3ot	negative
cpxa8l4	negative
cpxabr1	positive
cpxahi3	positive
cpxaiqm	positive
cpxajv6	positive
cpxasgh	negative
cpxatdy	positive
cpxaw5b	negative
cpxawx3	positive
cpxay9o	positive
cpxazs2	negative
cpxb14g	negative
cpxb20g	positive
cpxb2qo	positive
cpxb2tv	negative
cpxb8ur	negative
cpxbaq1	negative
cpxbbko	negative
cpxbm4f	negative
cpxbpe4	negative
cpxbub2	positive
cpxbwdh	negative
cpxbz3a	positive
cpxc52z	positive
cpxc87l	negative
cpxc8un	positive
cpxcjdh	positive
cpxcknl	negative
cpxcli0	positive
cpxcpxc	negative
cpxcpzr	negative
cpxcr85	positive
cpxcrb6	positive
cpxcueb	negative
cpxcuna	negative
cpxcvdm	positive
cpxcvts	negative
cpxcwvu	negative
